#############################
#.......#.......#.......#...#
#.......#.......#.......#...#
#.......#.......#.......#...#
#.......#.....#.........#...#
#.......#.....#.........#...#
#.......#.....#.........#...#
#.......................#...#
#.......#.....#.........#...#
#.......#.....#.........#...#
#.......#.....#.........#...#
#.......#.......#.......#...#
#.......#.......#.......#...#
#.......#.......#.......#...#
#############################
---
#############################
#       #       #       #   #
#       #       #           #
#       #       #       #   #
#       #     #         #   #
#       #     #         #   #
#       #     #         #   #
#                       #   #
#       #     #         #   #
#       #     #         #   #
#       #     #         #   #
#       #       #       #   #
#       #       #           #
#       #       #       #   #
#############################
---
#############################
#                           #
#                           #
#                           #
#       #     #         #   #
#       #     #         #   #
#       #     #         #   #
#                       #   #
#       #     #         #   #
#       #     #         #   #
#       #     #         #   #
#                           #
#                           #
#                           #
#############################

---
#############################
#       #       #       #   #
#       #       #       #   #
#       #       #       #   #
#       #     #         #   #
#       #     #         #   #
#       #     #         #   #
#                       #   #
#       #     #         #   #
#       #     #         #   #
#       #     #         #   #
#       #       #       #   #
#       #       #       #   #
#       #       #       #   #
#############################
/ Y=0 floor (.=dirt). Y>0 only # and space. --- separator
