# 0=пусто/воздух, 1=пол, 2=стена, 3=дверь, 4=яма

2,2,2,2,2,2,2,2,2,2
2,1,1,1,3,1,1,1,1,2
2,1,1,1,1,1,1,1,1,2
2,2,3,1,1,1,1,1,2,2
2,1,1,1,1,1,1,1,1,2
2,2,2,2,2,2,2,2,2,2